#####################
#Poooooooo#ooooooooo#
#o###o###o#o###o###o#
#+# #o# #o#o# #o# #+#
#o###o###o#o###o###o#
#ooooooooooooooooooo#
#####################